Plateau 15 17:
    01234567890123456
000 .................
001 .................
002 .................
003 .................
004 .................
005 ......xx.........
006 .......XX........
007 ........X........
008 ..O.....XXXX.....
009 ........XXXXX....
010 ...........XXXX..
011 ..............X..
012 ..............X..
013 .................
014 .................
Piece 2 3:
.**
.**