$$$ exec p1 : [./vinograd.filler]
launched players/carli.filler
$$$ exec p2 : [players/carli.filler]
Plateau 15 17:
    01234567890123456
000 .................
001 .................
002 .................
003 ..O..............
004 ..OO.............
005 ..OOO............
006 ...O.............
007 ...OO...X........
008 ....OOOXXX.......
009 .........XX......
010 ..........XXX....
011 ............XX...
012 .............XX..
013 .................
014 .................
Piece 2 2:
*.
**

[y-8 : x-6]
 	0  1  2  3  4  5  6  7  8  9  0  1  2  3  4  5  6
0	8  7  7  7  7  7  7  7  7  7  7  7  7  7  7  7  8 
1 	8  7  6  6  6  6  6  6  6  6  6  6  6  6  6  7  7 
2 	8  7  6  5  5  5  5  5  5  5  5  5  5  5  6  6  7 
3 	8  7 -5  5  4  4  4  4  4  4  4  4  4  5  5  6  6 
4 	8  8 -5 -5  4  3  3  3  3  3  3  3  4  4  5  5  6 
5 	7  7 -5 -5 -5  3  2  2  2  2  2  3  3  4  4  5  5 
6 	7  6  6 -5  3  2  2  1  1  1  2  2  3  3  4  4  4 
7 	7  6  5 -5 -5  2  1  1  0  1  1  2  2  3  3  3  4 
8 	7  6  5  4 -5 -5 -5  0  0  0  1  1  2  2  2  3  3 
9 	7  6  5  4  3  2  1  1  1  0  0  1  1  1  2  2  3 
10 	7  6  5  4  3  2  2  2  1  1  0  0  0  1  1  2  2 
11 	7  6  5  4  3  3  3  2  2  1  1  1  0  0  1  1  2 
12 	7  6  5  4  4  4  3  3  2  2  2  1  1  0  0  1  2 
13 	7  6  5  5  5  4  4  3  3  3  2  2  1  1  1  1  2 
14 	7  6  6  6  5  5  4  4  4  3  3  2  2  2  2  2  2 


*.
**

12 11 10 10 10 10 10 10 10 10 10 10 10 10 10 10 10 
12 11 10  9  9  9  9  9  9  9  9  9  9  9  9  9  9 
12 11 10  9  8  8  8  8  8  8  8  8  8  8  8  8  8 
12 11 -5  9  8  7  7  7  7  7  7  7  7  7  7  7  7 
12 12 -5 -5  8  7  6  6  6  6  6  6  6  6  6  6  6 
12 11 -5  9  8  7  6  5  5  5  5  5  5  5  5  5  5 
12 11 10  9  8  7  6  5  4  4  4  4  4  4  4  4  4 
12 11 10  9  8  7  6  5  4  3  3  3  3  3  3  3  4 
12 11 10  9  8  7  6  5  4  3  2  2  2  2  2  3  3 
12 11 10  9  8  7  6  5  4  3  2  1  1  1  2  2  3 
12 11 10  9  8  7  6  5  4  3  2  1  0  1  1  2  2 
12 11 10  9  8  7  6  5  4  3  2  1  0  0  1  1  2 
12 11 10  9  8  7  6  5  4  3  2  1  1  0  0  1  2 
12 11 10  9  8  7  6  5  4  3  2  2  1  1  1  1  2 
12 11 10  9  8  7  6  5  4  3  3  2  2  2  2  2  2

7 1
 6  +  5  5  5  5  5  5  5  5  5  5  5  6  6  7  8 
 6  5  4  4  4  4  4  4  4  4  4  4  5  5  6  7  7 
 6  5  4  3  3  3  3  3  3  3  3  4  4  5  6  6  6 
 6  5  4  3  2  2  2  2  2  2  3  3  4  5  5  5  5 
 6  5  4  3  2  1  1  1  1  2  2  3  4  4  4  4  5 
 6  5  4  3  2  1  0  0  1  1  2  3  3  3  3  4  4 
 6  5  4  3  2  1  1  0  0  1  2  2  2  2  3  3  4 
 +  5  4  3  2  2  1  1  0  1  1  1  1  2  2  3  3 
 6  5 -5  3  3  2  2  1  0  0  0  0  1  1  2  2  2 
 6  5  4  4  3  3  2  1  0  0  0  0  0  1  1  1  2 
 6  5  5  4  4  3  2  1  1  1  1  0  0  0  0  1  2 
 6  6  5  5  4  3  2  2  2  2  1  1  1  1  0  1  2 
 7  6  6  5  4  3  3  3  3  2  2  2  2  1  0  1  2 
 7  7  6  5  4  4  4  4  3  3  3  3  2  1  1  1  2 
 8  7  6  5  5  5  5  4  4  4  4  3  2  2  2  2  2 